v<<<<<<<<<<s<<<<<<<<<<<<
v<<<<<<<<<<s<<<<<<<<<<<^
vv##D#vv#SS##D#vv#####^^
vv####vv#^^####vv#####^^
vv####vv#^^D###vv####D^^
vv#D##vv#^^####SS#####^^
vv<<<<vv#^^<<<<<<s<<<<^^
vv<<<<vv#^^<<<<<<s<<<<^^
vv####vv#^^####vv#####^^
vvD###vv#^^####vv####D^^
vv###Dvv#^^D###vvD####^^
SS####vv#^^####vv#####^^
vvs<<<<<<<<<<<<<<<<<<<<<
vvs<<<<<<<<<<<<<<<<<<<<<
vv###vv###^^##########^^
vv>>>>>>>>>>>>>>>>>>>s^^
vv>>>>>>>>>>>>>>>>>>>s^^
vv####vv#^^####vv##D##SS
vvD###vv#^^D###vv#####^^
vv####vv#^^####vv<<<<<^^
vv###Dvv#^^####vv#####^^
vv####vv#^^###Dvv####D^^
vv####SS#^^####SS#####^^
v>>>>s>>>>>>>>s>>>>>>>^^
>>>>>s>>>>>>>>s>>>>>>>>^
